Uitleg bij aangeleverde data:

-PNG bestand waarin relaties tussen de tabellen wordt verklaard
-CSV bestanden met daarin de data

Verklarende woordenlijst voor de tabellen:
-Account: een bedrijf / reden van status en status geven aan of dit bedrijf nog actief is op dit moment of is stopgezet

-Activiteitscode: sector waarin een bedrijf actief kan zijn

-Account_Activiteitscode: relatie tussen een account en een activiteitscode

-Afspraak ALLE: geeft een overzicht van alle identifiers van afspraken. Afspraken kunnen in CRM op een verschillende manier worden ingevuld, vandaar dat in deze bestanden verschillende tabellen met verschillende informatie over afspraken worden weergegeven. Deze verschillende tabellen kunnen overlappende info bevatten.

-Afspraak ACCOUNT GELINKT: geeft een overzicht van alle afspraken waarbij de account is ingevuld in het veld CRM_accountID

-ActiviteitVereistContact: geeft aan of een contactpersoon uitgenodigd was of aanwezig was bij een afspraak (gelijkaardig aan hoe je in een email of kalender tool contacten via hun email adres kunt uitnodigen)

-Afspraak BETREFT ACCOUNT: geeft een overzicht van alle afspraken waarbij de account is ingevuld in het veld CRM_regardingID

-Afspraak BETREFT CONTACT: geeft een overzicht van alle afspraken waarbij de contact is ingevuld in het veld CRM_regardingID

-Campagne: een VOKA organisatie waarbij contactpersonen uitgenodigd worden en zich kunnen inschrijven in verschillende sessies. Dit kunnen evenementen, opleidingen, lerende netwerken etc. zijn. Elke campagne krijgt ook een URL op de voka website (deze kunnen intussen al gearchiveerd zijn)

-CDI_mailing: informatie over een email die is uitgestuurd naar een lijst contactpersonen

-CDI_pageview: informatie over bezoeken aan de website, waar mogelijk is de contactpersoon geïdentificeerd mbv cookie tracking

-CDI_sentemail kliks: informatie over wie op een uitgestuurde email geklikt heeft

-CDI_visit: informatie over een volledig bezoek van een contact aan de website. Dit bestaat uit meerdere pageviews

-Contact: De contactfiche bevat informatie over een bepaalde persoon die voor een bepaalde account werkt. Achterliggend wordt ook de persoon geregistreerd, deze kan meerdere contactfiche owv meerdere rollen binnen verschillende bedrijven bevatten. De status duidt aan of deze contact nog actief is binnen het bedrijf.

-Contactfunctie: informatie over de functie die een contact binnen een bedrijf uitvoert. De status geeft aan of dit op dit moment nog een actieve rol is of dit in het verleden was

-Financiële data: bevat financiële data (nl. toegevoegde waarde en aantal werknemers/FTE's) over een bedrijf in een bepaald boekjaar

-Functie: lijst van functies die een contact kan uitoefenen

-Gebruikers: lijst van Voka medewerkers die CRM gebruiken en beheerder kunnen zijn van accounts, contacten, afspraken, campagnes, etc.

-Info en klachten: geeft aan of de klant een aanvraag voor informatie of een klacht heeft ingediend bij Voka

-Inschrijving: geeft aan of een contact zich voor een campagne heeft ingeschreven en onder welke hoedanigheid. Deelnemers zijn de ingeschrevenen die betalen voor deelname.

-Lidmaatschap: geeft aan wanneer een account lid werd van voka en wanneer hij opgezegd heeft (indien relevant)

-Persoon: een natuurlijke persoon

-Sessie: onderdeel van een campagne - is een moment waarop de campagne deels wordt uitgevoerd 

-SessieInschrijving: geeft aan of een contact deelnam aan een bepaalde sessie. 

-Teams: In campagnes worden vaak prefixen gebruikt (OV = oost vlaanderen). Deze duiden de teams van Voka aan. 
Hieronder een verklarende lijst van prefixen en welk type campagnes zij typisch doen.

Teams:
JO: jong ondernemen (thematische opleidingen, trajecten, etc.)
DO: duurzaam ondernemen (thematische opleidingen, trajecten, etc.)
IN: innovatie en digitalisering (thematische opleidingen, trajecten, etc.)
IO: internationaal ondernemen (thematische opleidingen, trajecten, etc.)
AO: arbeidsmarkt en onderwijs (thematische opleidingen, trajecten, etc.)
EX: expert (thematische opleidingen, trajecten, etc.)
GR: Groei: biedt vooral Plato (P) en accelero aan
BB: Belangenbehartiging
CO: communicatie (verkoopt publiciteit, voert publiciteitscampagnes uit, etc.)
NW: netwerking (organiseert evenementen)
HA:  Haven (thematische opleidingen, trajecten, etc.)
MA: match (verkoopt lidmaatschappen)
